10 10
S 1 1 1 1 1 1 1 1 1
0 1 0 1 0 1 0 1 0 1
0 1 0 1 0 1 0 1 1 1
0 1 0 1 0 1 0 0 0 1
0 1 0 1 0 1 1 1 1 1
0 1 0 1 0 0 0 0 0 1
0 1 0 1 1 1 1 1 1 1
0 1 0 0 0 0 0 0 0 1
0 1 1 1 1 1 1 1 1 1
0 0 0 0 0 0 0 0 0 F
1 2 1 3 2 3 1 5 2 2
0 5 0 3 0 4 0 5 0 1
0 5 0 1 0 1 0 2 4 2
0 2 0 2 0 2 0 0 0 2
0 1 0 4 0 1 5 5 1 5
0 3 0 3 0 0 0 0 0 2
0 5 0 3 2 4 3 4 5 3
0 2 0 0 0 0 0 0 0 3
0 5 4 2 5 1 5 3 1 3
0 0 0 0 0 0 0 0 0 1
